1111111111111111111111111111111111111111111111111111111111111111111111111111111111111111111111111111111111111111111111111111111111111111111111111111111111111111111111111111111111111111111111111111111111111111111111111111111111111111111111111111111111111111111111111111111111111111111111111111111111111111111111111111111111111111111111111111111111111111111111111111111111111111111111111111111111111111111111111111111111111111111111111111111111111111111111111111111111111111111111111111111111111111111111111111111111111111111111111111111111111111111111111111111111111111111111111111111111111111111111111111111111111111111111111111111111111111111111111111111111111111111111111111111111111111111111111111111111111111111111111111111111111111111111111111111111111111111111111111111111111111111111111111111111111111111111111111111111111111111111111111111111111111111111111111111111111111111111111111111111111111111111111111111111111111111111111111111111111111111111111111111111111111111111111111111111111111111111111111111111111111111111111111111111111111111111111111111111111111111111111111111111111111111111111111111111111111111111111111111111111111111111111111111111111111111111111111111111111111111111111111111111111111111111111111111111111111111111111111111111111111111111111111111111111111111111111111111111111111111111111111111111111111111111111111111111111111111111111111111111111111111111111111111111111111111111111111111111111111111111111111111111111111111111111111111111111111111111111111111111111111111111111111111111111111111111111111111111111111111111111111111111111111111111111111111111111111111111111111111111111111111111111111111111111111111111111111111111111111111111111111111111111111111111111111111111111111111111111111111111111111111111111111111111111111111111111111111111111111111111111111111111111111111111111111111111111111111111111111111111111111111111111111111111111111111111111111111111111111111111111111111111111111111111111111111111111111111111111111111111111111111111111111111111111111111111111111111111111111111111111111111111111111111111111111111111111111111111111111111111111111111111111111111111111111111111111111111111111111111111111111111111111111111111111111111111111111111111111111111111111111111111111111111111111111111111111111111111111111111111111111111111111111111111111111111111111111111111111111111111111111111111111111111111111111111111111111111111111111111111111111111111111111111111111111111111111111111111111111111111111111111111111111111111111111111111111111111111111111111111111111111111111111111111111111111111111111111111111111111111111111111111111111111111111111111111
10C0C0000000000000000000000000000000000000000000000000000000000000010C0C0000000000000000000000000000000000000000000000000000000000000010C0C0000000000000000000000000000000000000000000000000000000000000010C0C0000000000000000000000000000000000000000000000000000000000000010C0C0000000000000000000000000000000000000000000000000000000000000010C0C0000000000000000000000000000000000000000000000000000000000000010C0C0000000000000000000000000000000000000000000000000000000000000010C0C0000000000000000000000000000000000000000000000000000000000000010C0C0000000000000000000000000000000000000000000000000000000000000010C0C0000000000000000000000000000000000000000000000000000000000000010C0C0000000000000000000000000000000000000000000000000000000000000010C0C0000000000000000000000000000000000000000000000000000000000000010C0C0000000000000000000000000000000000000000000000000000000000000010C0C0000000000000000000000000000000000000000000000000000000000000010C0C0000000000000000000000000000000000000000000000000000000000000010C0C0000000000000000000000000000000000000000000000000000000000000010C0C0000000000000000000000000000000000000000000000000000000000000010C0C0000000000000000000000000000000000000000000000000000000000000010C0C0000000000000000000000000000000000000000000000000000000000000010C0C0000000000000000000000000000000000000000000000000000000000000010C0C0000000000000000000000000000000000000000000000000000000000000010C0C0000000000000000000000000000000000000000000000000000000000000010C0C0000000000000000000000000000000000000000000000000000000000000010C0C0000000000000000000000000000000000000000000000000000000000000010C0C0000000000000000000000000000000000000000000000000000000000000010C0C0000000000000000000000000000000000000000000000000000000000000010C0C0000000000000000000000000000000000000000000000000000000000000010C0C0000000000000000000000000000000000000000000000000000000000000010C0C0000000000000000000000000000000000000000000000000000000000000010C0C0000000000000000000000000000000000000000000000000000000000000010C0C0000000000000000000000000000000000000000000000000000000000000010C0C0000000000000000000000000000000000000000000000000000000000000010C0C0000000000000000000000000000000000000000000000000000000000000010C0C0000000000000000000000000000000000000000000000000000000000000010C0C0000000000000000000000000000000000000000000000000000000000000010C0C0000000000000000000000000000000000000000000000000000000000000010C0C0000000000000000000000000000000000000000000000000000000000000010C0C0000000000000000000000000000000000000000000000000000000000000010C0C000000000000000000000000000000000000000000000000000000000000001
10C0C0000000000000000000000000000000000000000000000000000000000000010C0C0000000000000000000000000000000000000000000000000000000000000010C0C0000000000000000000000000000000000000000000000000000000000000010C0C0000000000000000000000000000000000000000000000000000000000000010C0C0000000000000000000000000000000000000000000000000000000000000010C0C0000000000000000000000000000000000000000000000000000000000000010C0C0000000000000000000000000000000000000000000000000000000000000010C0C0000000000000000000000000000000000000000000000000000000000000010C0C0000000000000000000000000000000000000000000000000000000000000010C0C0000000000000000000000000000000000000000000000000000000000000010C0C0000000000000000000000000000000000000000000000000000000000000010C0C0000000000000000000000000000000000000000000000000000000000000010C0C0000000000000000000000000000000000000000000000000000000000000010C0C0000000000000000000000000000000000000000000000000000000000000010C0C0000000000000000000000000000000000000000000000000000000000000010C0C0000000000000000000000000000000000000000000000000000000000000010C0C0000000000000000000000000000000000000000000000000000000000000010C0C0000000000000000000000000000000000000000000000000000000000000010C0C0000000000000000000000000000000000000000000000000000000000000010C0C0000000000000000000000000000000000000000000000000000000000000010C0C0000000000000000000000000000000000000000000000000000000000000010C0C0000000000000000000000000000000000000000000000000000000000000010C0C0000000000000000000000000000000000000000000000000000000000000010C0C0000000000000000000000000000000000000000000000000000000000000010C0C0000000000000000000000000000000000000000000000000000000000000010C0C0000000000000000000000000000000000000000000000000000000000000010C0C0000000000000000000000000000000000000000000000000000000000000010C0C0000000000000000000000000000000000000000000000000000000000000010C0C0000000000000000000000000000000000000000000000000000000000000010C0C0000000000000000000000000000000000000000000000000000000000000010C0C0000000000000000000000000000000000000000000000000000000000000010C0C0000000000000000000000000000000000000000000000000000000000000010C0C0000000000000000000000000000000000000000000000000000000000000010C0C0000000000000000000000000000000000000000000000000000000000000010C0C0000000000000000000000000000000000000000000000000000000000000010C0C0000000000000000000000000000000000000000000000000000000000000010C0C0000000000000000000000000000000000000000000000000000000000000010C0C0000000000000000000000000000000000000000000000000000000000000010C0C000000000000000000000000000000000000000000000000000000000000001
1000000000000000000000000000000000000000000000000000000000000000000000000000000000000000000000000000000000000000000000000000000000000000000000000000000000000000000000000000000000000000000000000000000000000000000000000000000000000000000000000000000000000000000000000000000000000000000000000000000000000000000000000000000000000000000000000000000000000000000000000000000000000000000000000000000000000000000000000000000000000000000000000000000000000000000000000000000000000000000000000000000000000000000000000000000000000000000000000000000000000000000000000000000000000000000000000000000000000000000000000000000000000000000000000000000000000000000000000000000000000000000000000000000000000000000000000000000000000000000000000000000000000000000000000000000000000000000000000000000000000000000000000000000000000000000000000000000000000000000000000000000000000000000000000000000000000000000000000000000000000000000000000000000000000000000000000000000000000000000000000000000000000000000000000000000000000000000000000000000000000000000000000000000000000000000000000000000000000000000000000000000000000000000000000000000000000000000000000000000000000000000000000000000000000000000000000000000000000000000000000000000000000000000000000000000000000000000000000000000000000000000000000000000000000000000000000000000000000000000000000000000000000000000000000000000000000000000000000000000000000000000000000000000000000000000000000000000000000000000000000000000000000000000000000000000000000000000000000000000000000000000000000000000000000000000000000000000000000000000000000000000000000000000000000000000000000000000000000000000000000000000000000000000000000000000000000000000000000000000000000000000000000000000000000000000000000000000000000000000000000000000000000000000000000000000000000000000000000000000000000000000000000000000000000000000000000000000000000000000000000000000000000000000000000000000000000000000000000000000000000000000000000000000000000000000000000000000000000000000000000000000000000000000000000000000000000000000000000000000000000000000000000000000000000000000000000000000000000000000000000000000000000000000000000000000000000000000000000000000000000000000000000000000000000000000000000000000000000000000000000000000000000000000000000000000000000000000000000000000000000000000000000000000000000000000000000000000000000000000000000000000000000000000000000000000000000000000000000000000000000000000000000000000000000000000000000000000000000000000000000000000000000000000P00000E00000000000000000000000000000000000000000000000000000000000000000000000000000000000000000000000000000000000000000000000000000001
1111111111111111111111111111111111111111111111111111111111111111111111111111111111111111111111111111111111111111111111111111111111111111111111111111111111111111111111111111111111111111111111111111111111111111111111111111111111111111111111111111111111111111111111111111111111111111111111111111111111111111111111111111111111111111111111111111111111111111111111111111111111111111111111111111111111111111111111111111111111111111111111111111111111111111111111111111111111111111111111111111111111111111111111111111111111111111111111111111111111111111111111111111111111111111111111111111111111111111111111111111111111111111111111111111111111111111111111111111111111111111111111111111111111111111111111111111111111111111111111111111111111111111111111111111111111111111111111111111111111111111111111111111111111111111111111111111111111111111111111111111111111111111111111111111111111111111111111111111111111111111111111111111111111111111111111111111111111111111111111111111111111111111111111111111111111111111111111111111111111111111111111111111111111111111111111111111111111111111111111111111111111111111111111111111111111111111111111111111111111111111111111111111111111111111111111111111111111111111111111111111111111111111111111111111111111111111111111111111111111111111111111111111111111111111111111111111111111111111111111111111111111111111111111111111111111111111111111111111111111111111111111111111111111111111111111111111111111111111111111111111111111111111111111111111111111111111111111111111111111111111111111111111111111111111111111111111111111111111111111111111111111111111111111111111111111111111111111111111111111111111111111111111111111111111111111111111111111111111111111111111111111111111111111111111111111111111111111111111111111111111111111111111111111111111111111111111111111111111111111111111111111111111111111111111111111111111111111111111111111111111111111111111111111111111111111111111111111111111111111111111111111111111111111111111111111111111111111111111111111111111111111111111111111111111111111111111111111111111111111111111111111111111111111111111111111111111111111111111111111111111111111111111111111111111111111111111111111111111111111111111111111111111111111111111111111111111111111111111111111111111111111111111111111111111111111111111111111111111111111111111111111111111111111111111111111111111111111111111111111111111111111111111111111111111111111111111111111111111111111111111111111111111111111111111111111111111111111111111111111111111111111111111111111111111111111111111111111111111111111111111111111111111111111111111111111111111111111111111111111111111111111111111111111111111111111