1111111111111111111111111111
1C000000000000000000010000C1
1000000010C00000000000000001
1111111110000000000001111111
10E0000000000000000P0000C001
100000000000000C000C00000001
1111111111111111111111111111