111111111111111111111111111
1000000000C0000000000000001
100000000000000000000000001
10000000000000000E000000001
10000000000000000P000000001
111111111111110011111111111
111111111111111111111111111