1111111111111111111111111111
11100000000000000000010000C1
1P00000010C00011101000000001
1111111110000000001110111111
10E0000000000010111010000001
100000000000001C101100000001
1111111111111111111111111111